XXXXXXXXXXXXXXXXXXXXX
X                   X
X X XXXXX XXX XXXXXXX
X X X     X X X     X
X X X XXX X X X XXX X
X X X X X X X X X X X
X X XXX XXX XXX X XXX
X X             X   X
XXX XXXXXXX     XXX X
X         X         X
XXXXXXXXXXXXXXXXXXXXX
